32 10 11
==========
=#=@===x==
=x#.....#=
=.=#==.#.=
=..x====.=
===.#===.=
=...==.#x=
=.==x===.=
=..#....x=
==#=x.====
==========
