36 10 8
==========
=x..@===x=
====.....=
=x==#===.=
=x#.....x=
=..===.===
==#....#x=
==========